{
    "tilebank": {
        "type": "external",
        "size": [16, 16],
        "filename": "tiles.png"
    },
    "size": [12, 12],
    "spritedepth": 1,
    "obstructions": {
        "data": [
            0, 0, 0, 0, 0, 0, 0, 0, 0, 0, 0, 0,
            0, 0, 0, 0, 0, 0, 0, 0, 0, 0, 0, 0,
            0, 0, 0, 0, 0, 0, 0, 0, 0, 0, 0, 0,
            0, 0, 0, 0, 0, 0, 0, 0, 0, 0, 0, 0,
            0, 0, 0, 0, 0, 0, 0, 0, 0, 0, 0, 0,
            0, 0, 0, 0, 0, 0, 0, 0, 0, 0, 0, 0,
            0, 0, 0, 0, 0, 0, 0, 0, 0, 0, 0, 0,
            0, 0, 0, 0, 0, 0, 0, 0, 0, 0, 0, 0,
            0, 0, 0, 0, 0, 0, 0, 0, 0, 0, 0, 0,
            0, 0, 0, 0, 0, 0, 0, 0, 0, 0, 0, 0,
            0, 0, 0, 0, 0, 0, 0, 0, 0, 0, 0, 0,
            0, 0, 0, 0, 0, 0, 0, 0, 0, 0, 0, 0
        ]
    },
    "layers": [
        {
            "data": [
                4, 1, 3, 1, 2, 3, 4, 2, 1, 2, 1, 4,
                1, 2, 1, 4, 1, 3, 1, 1, 1, 1, 1, 1,
                1, 2, 4, 1, 2, 1, 1, 4, 1, 3, 4, 1,
                3, 1, 3, 1, 1, 1, 2, 3, 1, 1, 1, 1,
                1, 4, 1, 2, 4, 1, 1, 1, 1, 1, 1, 4,
                4, 1, 3, 4, 1, 2, 1, 1, 1, 2, 1, 1,
                1, 1, 1, 3, 2, 1, 4, 3, 4, 1, 2, 1,
                1, 4, 1, 4, 1, 1, 2, 1, 1, 3, 1, 1,
                1, 1, 1, 1, 3, 4, 1, 4, 1, 1, 1, 1,
                1, 1, 3, 1, 1, 3, 1, 1, 4, 2, 1, 1,
                1, 2, 1, 2, 1, 1, 2, 1, 1, 1, 3, 1,
                4, 1, 1, 3, 1, 2, 1, 1, 2, 4, 1, 1
            ]
        },
        {
            "data": [
                0, 0, 0, 0, 0, 0, 0, 0, 0, 0, 0, 0,
                0, 0, 0, 0, 0, 0, 0, 0, 0, 0, 0, 0,
                0, 0, 0, 0, 0, 0, 0, 0, 0, 0, 0, 0,
                0, 0, 0, 0, 0, 0, 0, 0, 0, 0, 0, 0,
                0, 0, 0, 0, 0, 0, 0, 0, 0, 0, 0, 0,
                0, 0, 0, 0, 0, 0, 0, 0, 0, 0, 0, 0,
                0, 0, 0, 0, 0, 0, 0, 0, 0, 0, 0, 0,
                0, 0, 0, 0, 0, 0, 0, 0, 0, 0, 0, 0,
                0, 0, 0, 0, 0, 0, 0, 0, 0, 0, 0, 0,
                0, 0, 0, 0, 0, 0, 0, 0, 0, 0, 0, 0,
                0, 0, 0, 0, 0, 0, 0, 0, 0, 0, 0, 0,
                0, 0, 0, 0, 0, 0, 0, 0, 0, 0, 0, 0
            ]
        }
    ]
}